##########
#A      B#
#  ##  ###
#        #
##########
